team_year,total_tackles_def,solo_tackles_def,assisted_tackles_def,sacks_def,safties_def,passes_defended_def,ints_def,ints_for_tds_def,int_yards_def
arizona_cardinals_1994,0,0,0,9,0,0,1,1,59
arizona_cardinals_1995,0,0,0,3,0,0,3,0,42
arizona_cardinals_1996,0,0,0,2,0,0,3,0,23
arizona_cardinals_1997,0,0,0,12,0,0,3,0,15
arizona_cardinals_1998,0,0,0,10,0,0,10,0,80
arizona_cardinals_1999,0,0,0,6,0,0,8,1,157
arizona_cardinals_2000,0,0,0,15,0,0,4,0,41
arizona_cardinals_2001,670,516,154,5,0,29,13,0,153
arizona_cardinals_2002,547,408,139,12,0,24,7,0,64
arizona_cardinals_2003,548,461,87,15,0,35,8,0,152
arizona_cardinals_2004,511,407,104,16,0,43,7,0,84
arizona_cardinals_2005,483,397,86,19,0,27,9,3,179
arizona_cardinals_2006,366,304,62,20,0,18,4,0,128
arizona_cardinals_2007,455,375,80,16,0,20,4,0,69
arizona_cardinals_2008,527,427,100,17,0,32,7,1,243
arizona_cardinals_2009,551,463,88,24,0,46,10,1,123
arizona_cardinals_2010,794,651,143,19,0,68,15,3,420
arizona_cardinals_2011,801,648,153,33,0,71,9,0,100
arizona_cardinals_2012,732,585,147,25,0,66,21,2,308
arizona_cardinals_2013,754,651,103,25,2,98,20,4,251
arizona_cardinals_2014,838,690,148,34,0,52,15,3,256
arizona_cardinals_2015,867,721,146,33,2,68,19,4,263
arizona_cardinals_2016,944,747,197,23,2,68,14,2,263
atlanta_falcons_1976,0,0,0,0,0,0,0,0,0
atlanta_falcons_1977,0,0,0,0,0,0,0,0,0
atlanta_falcons_1978,0,0,0,0,0,0,0,0,0
atlanta_falcons_1979,0,0,0,0,0,0,0,0,0
atlanta_falcons_1980,0,0,0,0,0,0,12,0,193
atlanta_falcons_1981,0,0,0,0,0,0,4,0,44
atlanta_falcons_1982,0,0,0,6,0,0,2,0,30
atlanta_falcons_1983,0,0,0,13,0,0,3,2,95
atlanta_falcons_1984,0,0,0,14,1,0,6,1,110
atlanta_falcons_1985,0,0,0,23,0,0,7,1,121
atlanta_falcons_1986,0,0,0,13,1,0,5,0,47
atlanta_falcons_1987,0,0,0,5,0,0,3,0,40
atlanta_falcons_1988,0,0,0,10,0,0,12,0,57
atlanta_falcons_1989,0,0,0,9,0,0,13,0,197
atlanta_falcons_1990,0,0,0,13,0,0,9,3,207
atlanta_falcons_1991,0,0,0,7,0,0,10,1,177
atlanta_falcons_1992,0,0,0,11,0,0,7,0,121
atlanta_falcons_1993,0,0,0,10,0,0,10,0,101
atlanta_falcons_1994,0,0,0,13,0,0,11,1,139
atlanta_falcons_1995,0,0,0,10,0,0,6,0,5
atlanta_falcons_1996,0,0,0,23,0,0,1,0,0
atlanta_falcons_1997,0,0,0,17,0,0,2,0,14
atlanta_falcons_1998,0,0,0,6,0,0,1,0,0
atlanta_falcons_1999,0,0,0,13,0,0,3,0,68
atlanta_falcons_2000,0,0,0,13,0,0,5,1,147
atlanta_falcons_2001,364,303,61,6,0,17,8,0,50
atlanta_falcons_2002,422,357,65,16,0,25,14,1,215
atlanta_falcons_2003,506,426,80,26,0,26,10,2,130
atlanta_falcons_2004,556,475,81,10,0,48,11,3,306
atlanta_falcons_2005,539,442,97,13,1,28,10,0,212
atlanta_falcons_2006,416,347,69,20,0,30,8,1,176
atlanta_falcons_2007,387,350,37,8,0,30,6,0,84
atlanta_falcons_2008,337,288,49,13,0,33,3,1,121
atlanta_falcons_2009,591,478,113,21,0,43,12,0,94
atlanta_falcons_2010,600,474,126,13,0,50,14,1,187
atlanta_falcons_2011,616,446,170,23,0,54,9,0,111
atlanta_falcons_2012,656,513,143,13,0,67,15,1,191
atlanta_falcons_2013,751,522,229,21,0,48,7,2,140
atlanta_falcons_2014,709,496,213,14,0,56,15,1,98
atlanta_falcons_2015,789,596,193,14,0,57,13,1,206
atlanta_falcons_2016,985,682,303,19,0,89,12,3,279
baltimore_colts_1973,0,0,0,0,0,0,2,0,10
baltimore_colts_1974,0,0,0,0,0,0,1,0,3
baltimore_colts_1975,0,0,0,0,0,0,2,0,23
baltimore_colts_1976,0,0,0,0,0,0,2,0,40
baltimore_colts_1977,0,0,0,0,0,0,0,0,0
baltimore_colts_1978,0,0,0,0,0,0,0,0,0
baltimore_colts_1979,0,0,0,0,0,0,1,0,-1
baltimore_colts_1980,0,0,0,0,0,0,7,0,105
baltimore_colts_1981,0,0,0,0,0,0,3,0,84
baltimore_colts_1982,0,0,0,2,0,0,2,0,25
baltimore_colts_1983,0,0,0,11,1,0,8,1,163
baltimore_ravens_1996,0,0,0,13,0,0,7,1,104
baltimore_ravens_1997,0,0,0,10,0,0,9,1,137
baltimore_ravens_1998,0,0,0,6,0,0,3,0,25
baltimore_ravens_1999,0,0,0,13,1,0,9,1,149
baltimore_ravens_2000,0,0,0,5,0,0,9,1,255
baltimore_ravens_2001,608,476,132,15,0,46,6,0,116
baltimore_ravens_2002,728,589,139,16,0,58,15,1,257
baltimore_ravens_2003,712,569,143,17,0,61,23,3,459
baltimore_ravens_2004,815,609,206,20,0,52,18,4,544
baltimore_ravens_2005,686,552,134,27,0,37,9,1,166
baltimore_ravens_2006,707,547,160,31,2,66,23,4,418
baltimore_ravens_2007,782,585,197,24,0,78,16,1,212
baltimore_ravens_2008,751,597,154,23,0,93,23,5,472
baltimore_ravens_2009,855,683,172,20,0,79,21,2,346
baltimore_ravens_2010,812,634,178,15,0,67,16,2,277
baltimore_ravens_2011,649,492,157,29,0,73,13,1,167
baltimore_ravens_2012,770,564,206,30,0,59,8,1,106
baltimore_ravens_2013,936,606,330,27,0,97,15,1,160
baltimore_ravens_2014,934,606,328,19,1,70,9,0,85
baltimore_ravens_2015,863,595,268,34,0,58,5,1,26
baltimore_ravens_2016,818,556,262,31,0,66,15,0,155
buffalo_bills_1974,0,0,0,0,0,0,0,0,0
buffalo_bills_1975,0,0,0,0,0,0,0,0,0
buffalo_bills_1976,0,0,0,0,0,0,0,0,0
buffalo_bills_1977,0,0,0,0,0,0,0,0,0
buffalo_bills_1978,0,0,0,0,0,0,1,0,41
buffalo_bills_1979,0,0,0,0,0,0,4,0,59
buffalo_bills_1980,0,0,0,0,1,0,2,0,30
buffalo_bills_1981,0,0,0,0,0,0,0,0,0
buffalo_bills_1982,0,0,0,0,0,0,2,0,14
buffalo_bills_1983,0,0,0,13,0,0,4,0,59
buffalo_bills_1984,0,0,0,14,0,0,1,0,0
buffalo_bills_1985,0,0,0,8,0,0,4,0,50
buffalo_bills_1986,0,0,0,8,0,0,1,0,0
buffalo_bills_1987,0,0,0,7,0,0,3,0,4
buffalo_bills_1988,0,0,0,6,0,0,2,0,3
buffalo_bills_1989,0,0,0,12,0,0,8,1,79
buffalo_bills_1990,0,0,0,10,0,0,7,1,76
buffalo_bills_1991,0,0,0,9,0,0,14,1,196
buffalo_bills_1992,0,0,0,17,0,0,5,0,19
buffalo_bills_1993,0,0,0,10,0,0,15,2,166
buffalo_bills_1994,0,0,0,6,0,0,6,0,82
buffalo_bills_1995,0,0,0,6,0,0,8,1,48
buffalo_bills_1996,0,0,0,30,0,0,7,0,36
buffalo_bills_1997,0,0,0,19,1,0,8,0,100
buffalo_bills_1998,0,0,0,13,1,0,11,1,158
buffalo_bills_1999,0,0,0,12,0,0,4,0,27
buffalo_bills_2000,0,0,0,15,0,0,8,0,64
buffalo_bills_2001,490,358,132,23,0,22,4,0,40
buffalo_bills_2002,469,323,146,24,0,18,2,0,31
buffalo_bills_2003,382,264,118,11,0,16,2,1,43
buffalo_bills_2004,519,326,193,29,0,15,5,0,70
buffalo_bills_2005,611,411,200,17,1,25,8,0,133
buffalo_bills_2006,720,488,232,16,0,30,6,1,47
buffalo_bills_2007,715,539,176,19,1,32,8,1,158
buffalo_bills_2008,622,477,145,14,0,35,3,1,73
buffalo_bills_2009,854,606,248,17,0,54,21,2,309
buffalo_bills_2010,978,669,309,20,0,61,9,2,145
buffalo_bills_2011,817,567,250,21,1,52,14,4,296
buffalo_bills_2012,793,569,224,20,1,63,11,1,179
buffalo_bills_2013,1022,691,331,21,0,84,21,2,289
buffalo_bills_2014,1008,721,287,16,0,70,19,0,322
buffalo_bills_2015,866,640,226,20,0,83,16,2,253
buffalo_bills_2016,1068,734,334,26,0,74,12,1,207
carolina_panthers_1995,0,0,0,19,0,0,9,0,92
carolina_panthers_1996,0,0,0,12,0,0,10,0,99
carolina_panthers_1997,0,0,0,14,0,0,6,0,26
carolina_panthers_1998,0,0,0,15,0,0,8,2,109
carolina_panthers_1999,0,0,0,13,0,0,12,0,100
carolina_panthers_2000,0,0,0,8,0,0,10,0,45
carolina_panthers_2001,390,324,66,4,0,18,9,1,126
carolina_panthers_2002,370,292,78,19,0,23,2,0,58
carolina_panthers_2003,367,305,62,20,0,20,5,1,91
carolina_panthers_2004,449,376,73,7,0,24,14,1,239
carolina_panthers_2005,356,288,68,11,0,20,11,1,215
carolina_panthers_2006,591,474,117,16,0,43,6,2,90
carolina_panthers_2007,781,637,144,15,0,48,9,1,143
carolina_panthers_2008,852,707,145,18,0,70,10,0,118
carolina_panthers_2009,868,695,173,12,1,62,22,1,235
carolina_panthers_2010,876,696,180,14,1,59,15,1,287
carolina_panthers_2011,790,580,210,27,2,69,13,0,144
carolina_panthers_2012,988,651,337,14,1,64,11,3,181
carolina_panthers_2013,790,542,248,29,0,55,18,3,225
carolina_panthers_2014,861,572,289,38,0,67,13,2,327
carolina_panthers_2015,1007,676,331,33,0,83,24,4,301
carolina_panthers_2016,1025,695,330,44,1,70,17,1,204
chicago_bears_1972,0,0,0,0,0,0,0,0,0
chicago_bears_1973,0,0,0,0,0,0,0,0,0
chicago_bears_1974,0,0,0,0,0,0,0,0,0
chicago_bears_1975,0,0,0,0,1,0,0,0,0
chicago_bears_1976,0,0,0,0,0,0,0,1,12
chicago_bears_1977,0,0,0,0,0,0,4,0,33
chicago_bears_1978,0,0,0,0,0,0,4,0,77
chicago_bears_1979,0,0,0,0,0,0,7,0,63
chicago_bears_1980,0,0,0,0,0,0,4,0,44
chicago_bears_1981,0,0,0,0,0,0,8,3,257
chicago_bears_1982,0,0,0,21,1,0,2,0,2
chicago_bears_1983,0,0,0,26,0,0,2,0,34
chicago_bears_1984,0,0,0,21,0,0,11,1,181
chicago_bears_1985,0,0,0,23,1,0,12,1,80
chicago_bears_1986,0,0,0,17,1,0,10,1,117
chicago_bears_1987,0,0,0,29,0,0,4,1,45
chicago_bears_1988,0,0,0,17,0,0,7,0,35
chicago_bears_1989,0,0,0,25,0,0,7,0,70
chicago_bears_1990,0,0,0,7,0,0,7,0,39
chicago_bears_1991,0,0,0,8,0,0,5,0,55
chicago_bears_1992,0,0,0,19,0,0,2,0,39
chicago_bears_1993,0,0,0,11,0,0,5,1,133
chicago_bears_1994,0,0,0,17,0,0,3,0,38
chicago_bears_1995,0,0,0,10,1,0,5,0,54
chicago_bears_1996,0,0,0,13,0,0,7,0,54
chicago_bears_1997,0,0,0,18,0,0,13,0,60
chicago_bears_1998,0,0,0,23,1,0,9,1,83
chicago_bears_1999,0,0,0,10,0,0,5,0,82
chicago_bears_2000,0,0,0,22,0,0,8,2,156
chicago_bears_2001,365,305,60,18,0,27,7,1,141
chicago_bears_2002,368,288,80,13,0,9,1,0,0
chicago_bears_2003,354,281,73,5,0,19,4,0,27
chicago_bears_2004,451,351,100,16,1,25,6,1,219
chicago_bears_2005,578,477,101,18,0,41,17,2,364
chicago_bears_2006,707,537,170,17,1,50,20,1,239
chicago_bears_2007,685,569,116,32,0,49,12,1,196
chicago_bears_2008,705,592,113,18,1,73,14,1,258
chicago_bears_2009,629,497,132,21,1,29,5,1,77
chicago_bears_2010,727,577,150,27,0,65,15,0,236
chicago_bears_2011,591,484,107,14,1,45,12,2,86
chicago_bears_2012,550,423,127,14,0,59,15,5,292
chicago_bears_2013,531,404,127,21,0,38,13,3,266
chicago_bears_2014,671,474,197,26,0,40,8,0,87
chicago_bears_2015,819,654,165,33,0,49,8,0,103
chicago_bears_2016,946,735,211,36,1,64,7,1,52
cincinnati_bengals_1972,0,0,0,0,0,0,0,0,0
cincinnati_bengals_1973,0,0,0,0,0,0,0,0,0
cincinnati_bengals_1974,0,0,0,0,0,0,0,0,0
cincinnati_bengals_1975,0,0,0,0,0,0,3,0,25
cincinnati_bengals_1976,0,0,0,0,0,0,3,0,6
cincinnati_bengals_1977,0,0,0,0,0,0,4,0,25
cincinnati_bengals_1978,0,0,0,0,0,0,3,0,14
cincinnati_bengals_1979,0,0,0,0,0,0,1,0,0
cincinnati_bengals_1980,0,0,0,0,0,0,3,0,43
cincinnati_bengals_1981,0,0,0,0,0,0,4,0,92
cincinnati_bengals_1982,0,0,0,11,0,0,3,1,73
cincinnati_bengals_1983,0,0,0,5,0,0,3,0,26
cincinnati_bengals_1984,0,0,0,12,0,0,6,0,42
cincinnati_bengals_1985,0,0,0,17,0,0,1,0,0
cincinnati_bengals_1986,0,0,0,21,0,0,4,0,31
cincinnati_bengals_1987,0,0,0,16,1,0,1,0,3
cincinnati_bengals_1988,0,0,0,3,0,0,8,0,64
cincinnati_bengals_1989,0,0,0,5,0,0,5,1,43
cincinnati_bengals_1990,0,0,0,11,1,0,2,1,29
cincinnati_bengals_1991,0,0,0,6,1,0,5,0,29
cincinnati_bengals_1992,0,0,0,12,0,0,4,1,120
cincinnati_bengals_1993,0,0,0,2,0,0,2,0,36
cincinnati_bengals_1994,0,0,0,5,0,0,5,0,36
cincinnati_bengals_1995,0,0,0,7,0,0,6,0,117
cincinnati_bengals_1996,0,0,0,10,0,0,18,2,159
cincinnati_bengals_1997,0,0,0,10,0,0,10,0,131
cincinnati_bengals_1998,0,0,0,8,0,0,6,1,91
cincinnati_bengals_1999,0,0,0,19,0,0,3,0,5
cincinnati_bengals_2000,0,0,0,13,0,0,6,0,59
cincinnati_bengals_2001,383,297,86,3,0,24,4,0,51
cincinnati_bengals_2002,298,223,75,2,0,13,5,0,29
cincinnati_bengals_2003,462,349,113,13,0,29,8,0,83
cincinnati_bengals_2004,529,390,139,14,0,47,13,2,162
cincinnati_bengals_2005,630,468,162,7,0,28,28,1,243
cincinnati_bengals_2006,672,477,195,13,0,56,14,1,210
cincinnati_bengals_2007,690,486,204,12,1,58,16,1,180
cincinnati_bengals_2008,741,479,262,14,0,61,8,1,195
cincinnati_bengals_2009,707,487,220,28,0,75,17,2,221
cincinnati_bengals_2010,711,479,232,20,0,55,14,1,200
cincinnati_bengals_2011,671,435,236,35,0,50,8,1,132
cincinnati_bengals_2012,897,562,335,24,0,59,10,2,91
cincinnati_bengals_2013,954,644,310,39,0,88,18,3,159
cincinnati_bengals_2014,1066,660,406,19,2,96,20,1,161
cincinnati_bengals_2015,993,696,297,17,0,87,21,1,202
cincinnati_bengals_2016,1044,692,352,31,0,85,17,0,138
cleveland_browns_1978,0,0,0,0,0,0,1,0,5
cleveland_browns_1979,0,0,0,0,0,0,1,0,30
cleveland_browns_1980,0,0,0,0,0,0,2,0,9
cleveland_browns_1981,0,0,0,0,0,0,2,0,14
cleveland_browns_1982,0,0,0,14,0,0,5,0,31
cleveland_browns_1983,0,0,0,23,0,0,6,2,102
cleveland_browns_1984,0,0,0,15,0,0,4,0,11
cleveland_browns_1985,0,0,0,30,0,0,2,0,15
cleveland_browns_1986,0,0,0,22,0,0,5,0,55
cleveland_browns_1987,0,0,0,20,0,0,7,1,132
cleveland_browns_1988,0,0,0,19,0,0,9,1,153
cleveland_browns_1989,0,0,0,36,0,0,10,2,141
cleveland_browns_1990,0,0,0,10,0,0,3,1,95
cleveland_browns_1991,0,0,0,18,0,0,4,0,75
cleveland_browns_1992,0,0,0,21,0,0,7,0,87
cleveland_browns_1993,0,0,0,21,1,0,2,0,10
cleveland_browns_1994,0,0,0,10,0,0,3,0,2
cleveland_browns_1995,0,0,0,9,0,0,8,1,116
cleveland_browns_1999,0,0,0,13,0,0,4,0,22
cleveland_browns_2000,0,0,0,4,0,0,5,1,45
cleveland_browns_2001,343,267,76,8,0,15,9,0,104
cleveland_browns_2002,326,253,73,9,0,12,9,0,119
cleveland_browns_2003,488,362,126,18,0,14,8,0,41
cleveland_browns_2004,482,350,132,21,0,25,7,0,129
cleveland_browns_2005,521,354,167,12,0,11,3,0,24
cleveland_browns_2006,448,334,114,7,0,14,3,0,29
cleveland_browns_2007,301,228,73,8,0,13,1,0,1
cleveland_browns_2008,407,292,115,5,0,13,6,0,51
cleveland_browns_2009,479,370,109,7,0,18,0,0,0
cleveland_browns_2010,636,496,140,9,0,51,13,0,210
cleveland_browns_2011,825,598,227,26,0,54,6,0,90
cleveland_browns_2012,928,650,278,33,0,68,14,1,210
cleveland_browns_2013,1021,662,359,34,0,84,14,3,274
cleveland_browns_2014,1013,629,384,19,1,86,20,1,310
cleveland_browns_2015,944,637,307,25,0,51,11,2,210
cleveland_browns_2016,1038,704,334,23,0,67,10,1,146
dallas_cowboys_1972,0,0,0,0,0,0,0,0,0
dallas_cowboys_1973,0,0,0,0,2,0,1,0,1
dallas_cowboys_1974,0,0,0,0,0,0,0,0,0
dallas_cowboys_1975,0,0,0,0,0,0,0,0,0
dallas_cowboys_1976,0,0,0,0,0,0,2,0,23
dallas_cowboys_1977,0,0,0,0,0,0,0,0,0
dallas_cowboys_1978,0,0,0,0,0,0,8,0,114
dallas_cowboys_1979,0,0,0,0,1,0,4,0,23
dallas_cowboys_1980,0,0,0,0,0,0,8,1,190
dallas_cowboys_1981,0,0,0,0,1,0,21,0,344
dallas_cowboys_1982,0,0,0,11,0,0,11,1,140
dallas_cowboys_1983,0,0,0,10,1,0,12,0,156
dallas_cowboys_1984,0,0,0,10,0,0,11,1,101
dallas_cowboys_1985,0,0,0,6,0,0,21,3,158
dallas_cowboys_1986,0,0,0,6,0,0,4,0,77
dallas_cowboys_1987,0,0,0,15,0,0,11,1,114
dallas_cowboys_1988,0,0,0,21,1,0,4,1,17
dallas_cowboys_1989,0,0,0,9,0,0,2,0,21
dallas_cowboys_1990,0,0,0,17,0,0,2,0,30
dallas_cowboys_1991,0,0,0,18,0,0,2,1,36
dallas_cowboys_1992,0,0,0,26,0,0,5,0,47
dallas_cowboys_1993,0,0,0,24,0,0,7,0,77
dallas_cowboys_1994,0,0,0,24,0,0,4,1,66
dallas_cowboys_1995,0,0,0,13,0,0,8,1,74
dallas_cowboys_1996,0,0,0,13,0,0,8,0,80
dallas_cowboys_1997,0,0,0,22,0,0,2,1,81
dallas_cowboys_1998,0,0,0,19,0,0,9,1,159
dallas_cowboys_1999,0,0,0,21,1,0,14,3,304
dallas_cowboys_2000,0,0,0,19,1,0,4,0,91
dallas_cowboys_2001,521,417,104,16,0,38,2,1,113
dallas_cowboys_2002,507,411,96,17,0,30,4,0,36
dallas_cowboys_2003,470,365,105,22,1,48,5,1,50
dallas_cowboys_2004,589,459,130,22,0,38,10,0,54
dallas_cowboys_2005,615,488,127,28,0,46,8,0,33
dallas_cowboys_2006,544,410,134,13,0,41,8,2,119
dallas_cowboys_2007,589,442,147,15,0,59,11,1,240
dallas_cowboys_2008,766,572,194,33,0,49,7,1,36
dallas_cowboys_2009,641,507,134,14,0,69,10,1,36
dallas_cowboys_2010,595,479,116,9,0,48,16,3,234
dallas_cowboys_2011,671,516,155,11,0,44,14,1,202
dallas_cowboys_2012,654,449,205,6,0,42,6,1,147
dallas_cowboys_2013,879,681,198,20,0,63,15,2,257
dallas_cowboys_2014,826,640,186,15,0,65,18,2,228
dallas_cowboys_2015,939,639,300,30,1,51,8,1,62
dallas_cowboys_2016,997,698,299,31,0,64,9,0,75
denver_broncos_1971,0,0,0,0,0,0,0,0,0
denver_broncos_1972,0,0,0,0,0,0,0,0,0
denver_broncos_1973,0,0,0,0,0,0,0,0,0
denver_broncos_1974,0,0,0,0,0,0,1,0,39
denver_broncos_1975,0,0,0,0,0,0,5,1,77
denver_broncos_1976,0,0,0,0,0,0,10,2,180
denver_broncos_1977,0,0,0,0,0,0,7,1,151
denver_broncos_1978,0,0,0,0,1,0,7,1,47
denver_broncos_1979,0,0,0,0,0,0,1,0,34
denver_broncos_1980,0,0,0,0,0,0,5,2,131
denver_broncos_1981,0,0,0,0,0,0,7,0,88
denver_broncos_1982,0,0,0,11,1,0,3,0,11
denver_broncos_1983,0,0,0,16,0,0,7,0,147
denver_broncos_1984,0,0,0,21,0,0,10,2,169
denver_broncos_1985,0,0,0,9,0,0,8,1,107
denver_broncos_1986,0,0,0,15,0,0,10,2,206
denver_broncos_1987,0,0,0,5,0,0,11,0,133
denver_broncos_1988,0,0,0,12,0,0,8,0,135
denver_broncos_1989,0,0,0,7,0,0,7,1,55
denver_broncos_1990,0,0,0,5,1,0,3,0,37
denver_broncos_1991,0,0,0,5,0,0,10,1,204
denver_broncos_1992,0,0,0,4,0,0,4,0,50
denver_broncos_1993,0,0,0,3,0,0,5,0,85
denver_broncos_1994,0,0,0,12,0,0,4,0,35
denver_broncos_1995,0,0,0,18,0,0,6,0,78
denver_broncos_1996,0,0,0,15,0,0,7,0,43
denver_broncos_1997,0,0,0,12,0,0,6,2,106
denver_broncos_1998,0,0,0,18,0,0,9,1,219
denver_broncos_1999,0,0,0,18,0,0,7,0,107
denver_broncos_2000,0,0,0,17,0,0,5,1,61
denver_broncos_2001,363,305,58,11,0,32,13,1,181
denver_broncos_2002,467,385,82,8,0,29,8,2,107
denver_broncos_2003,308,256,52,4,0,28,5,1,20
denver_broncos_2004,362,286,76,14,0,26,5,1,53
denver_broncos_2005,458,381,77,11,1,47,15,2,221
denver_broncos_2006,595,466,129,29,0,34,12,1,207
denver_broncos_2007,621,500,121,8,0,47,8,0,34
denver_broncos_2008,638,496,142,18,0,26,4,0,58
denver_broncos_2009,706,555,151,11,0,61,15,0,153
denver_broncos_2010,638,537,101,14,0,57,7,0,37
denver_broncos_2011,782,604,178,21,0,52,8,3,150
denver_broncos_2012,804,583,221,22,2,69,13,4,294
denver_broncos_2013,838,638,200,27,0,89,15,1,139
denver_broncos_2014,775,629,146,15,0,81,17,2,208
denver_broncos_2015,876,670,206,38,1,75,11,4,297
denver_broncos_2016,997,738,259,27,0,84,14,3,367
detroit_lions_1975,0,0,0,0,0,0,0,0,0
detroit_lions_1976,0,0,0,0,0,0,0,0,0
detroit_lions_1977,0,0,0,0,1,0,0,0,0
detroit_lions_1978,0,0,0,0,0,0,0,0,0
detroit_lions_1979,0,0,0,0,1,0,0,0,0
detroit_lions_1980,0,0,0,0,0,0,5,1,49
detroit_lions_1981,0,0,0,0,0,0,5,1,97
detroit_lions_1982,0,0,0,21,0,0,3,1,44
detroit_lions_1983,0,0,0,7,3,0,6,0,88
detroit_lions_1984,0,0,0,7,0,0,3,0,65
detroit_lions_1985,0,0,0,20,0,0,6,0,65
detroit_lions_1986,0,0,0,19,0,0,3,0,25
detroit_lions_1987,0,0,0,18,1,0,2,0,5
detroit_lions_1988,0,0,0,17,0,0,3,1,56
detroit_lions_1989,0,0,0,12,0,0,2,0,10
detroit_lions_1990,0,0,0,10,0,0,2,0,50
detroit_lions_1991,0,0,0,13,1,0,4,0,52
detroit_lions_1992,0,0,0,14,0,0,4,0,34
detroit_lions_1993,0,0,0,14,0,0,5,1,49
detroit_lions_1994,0,0,0,13,0,0,2,1,48
detroit_lions_1995,0,0,0,14,0,0,8,0,67
detroit_lions_1996,0,0,0,16,0,0,2,1,24
detroit_lions_1997,0,0,0,24,1,0,7,1,128
detroit_lions_1998,0,0,0,22,0,0,7,1,95
detroit_lions_1999,0,0,0,20,0,0,10,1,170
detroit_lions_2000,0,0,0,12,0,0,20,2,249
detroit_lions_2001,456,336,120,9,0,29,10,2,134
detroit_lions_2002,590,458,132,15,0,48,5,0,79
detroit_lions_2003,490,404,86,9,0,24,5,0,-1
detroit_lions_2004,675,505,170,20,1,27,9,0,107
detroit_lions_2005,576,437,139,17,0,26,9,2,178
detroit_lions_2006,514,385,129,21,1,11,6,1,139
detroit_lions_2007,646,481,165,17,1,26,8,1,201
detroit_lions_2008,579,427,152,15,0,24,1,0,18
detroit_lions_2009,655,466,189,14,1,42,5,2,176
detroit_lions_2010,754,545,209,29,0,32,4,1,61
detroit_lions_2011,623,460,163,26,0,22,6,2,73
detroit_lions_2012,715,534,181,27,1,37,6,0,89
detroit_lions_2013,775,564,211,31,2,70,13,1,177
detroit_lions_2014,837,652,185,32,1,72,20,1,388
detroit_lions_2015,898,697,201,22,0,60,9,1,103
detroit_lions_2016,950,725,225,25,1,63,10,1,96
green_bay_packers_1977,0,0,0,0,0,0,0,0,0
green_bay_packers_1978,0,0,0,0,0,0,5,0,27
green_bay_packers_1979,0,0,0,0,0,0,1,0,0
green_bay_packers_1980,0,0,0,0,0,0,0,0,0
green_bay_packers_1981,0,0,0,0,0,0,9,0,229
green_bay_packers_1982,0,0,0,6,0,0,5,0,54
green_bay_packers_1983,0,0,0,10,0,0,6,1,66
green_bay_packers_1984,0,0,0,20,0,0,3,0,24
green_bay_packers_1985,0,0,0,33,0,0,5,0,52
green_bay_packers_1986,0,0,0,21,0,0,7,0,56
green_bay_packers_1987,0,0,0,20,0,0,5,0,40
green_bay_packers_1988,0,0,0,7,2,0,0,0,0
green_bay_packers_1989,0,0,0,6,0,0,4,0,64
green_bay_packers_1990,0,0,0,14,0,0,1,1,9
green_bay_packers_1991,0,0,0,15,1,0,0,0,0
green_bay_packers_1992,0,0,0,11,0,0,0,0,0
green_bay_packers_1993,0,0,0,5,0,0,3,0,30
green_bay_packers_1994,0,0,0,10,0,0,7,1,80
green_bay_packers_1995,0,0,0,5,0,0,6,0,136
green_bay_packers_1996,0,0,0,3,0,0,8,2,186
green_bay_packers_1997,0,0,0,2,0,0,6,2,103
green_bay_packers_1998,0,0,0,5,0,0,1,0,9
green_bay_packers_1999,0,0,0,3,0,0,10,1,59
green_bay_packers_2000,0,0,0,12,1,0,13,0,156
green_bay_packers_2001,592,434,158,23,1,39,12,0,154
green_bay_packers_2002,742,515,227,12,0,35,19,4,513
green_bay_packers_2003,790,638,152,15,0,43,15,1,209
green_bay_packers_2004,694,547,147,17,0,43,7,2,142
green_bay_packers_2005,752,548,204,26,0,43,7,2,187
green_bay_packers_2006,551,386,165,16,0,34,9,2,108
green_bay_packers_2007,435,343,92,15,0,28,5,0,79
green_bay_packers_2008,444,360,84,13,0,41,5,0,78
green_bay_packers_2009,499,388,111,17,0,39,7,0,127
green_bay_packers_2010,500,402,98,26,0,45,14,1,173
green_bay_packers_2011,573,434,139,14,0,73,21,3,355
green_bay_packers_2012,633,457,176,20,0,71,16,1,246
green_bay_packers_2013,726,527,199,31,0,53,9,0,29
green_bay_packers_2014,855,647,208,28,0,82,17,3,386
green_bay_packers_2015,960,737,223,32,0,72,16,2,198
green_bay_packers_2016,919,712,207,28,0,88,17,0,209
houston_oilers_1973,0,0,0,0,0,0,0,0,0
houston_oilers_1974,0,0,0,0,0,0,0,0,0
houston_oilers_1975,0,0,0,0,0,0,3,0,30
houston_oilers_1976,0,0,0,0,0,0,0,0,0
houston_oilers_1977,0,0,0,0,1,0,3,0,26
houston_oilers_1978,0,0,0,0,0,0,1,0,6
houston_oilers_1979,0,0,0,0,0,0,2,0,24
houston_oilers_1980,0,0,0,0,0,0,1,0,0
houston_oilers_1981,0,0,0,0,0,0,4,0,97
houston_oilers_1982,0,0,0,12,0,0,0,0,0
houston_oilers_1983,0,0,0,18,0,0,2,0,0
houston_oilers_1984,0,0,0,7,0,0,5,0,49
houston_oilers_1985,0,0,0,13,0,0,4,0,69
houston_oilers_1986,0,0,0,13,0,0,4,0,22
houston_oilers_1987,0,0,0,16,1,0,3,1,70
houston_oilers_1988,0,0,0,9,2,0,5,0,97
houston_oilers_1989,0,0,0,10,0,0,5,0,31
houston_oilers_1990,0,0,0,10,1,0,16,1,225
houston_oilers_1991,0,0,0,12,0,0,14,2,189
houston_oilers_1992,0,0,0,6,0,0,7,0,52
houston_oilers_1993,0,0,0,15,0,0,15,3,243
houston_oilers_1994,0,0,0,23,1,0,10,1,131
houston_oilers_1995,0,0,0,14,0,0,12,1,165
houston_oilers_1996,0,0,0,21,1,0,6,1,110
houston_texans_2002,590,450,140,16,1,42,5,2,181
houston_texans_2003,697,504,193,13,0,43,1,0,0
houston_texans_2004,613,461,152,10,0,31,9,1,107
houston_texans_2005,477,353,124,25,0,31,4,0,34
houston_texans_2006,477,375,102,21,0,30,4,0,23
houston_texans_2007,377,293,84,13,0,15,0,0,0
houston_texans_2008,516,391,125,5,0,31,6,1,116
houston_texans_2009,569,433,136,24,2,48,7,0,48
houston_texans_2010,757,560,197,25,0,48,12,0,72
houston_texans_2011,772,607,165,30,0,91,17,1,196
houston_texans_2012,820,626,194,23,1,104,14,3,326
houston_texans_2013,896,690,206,20,1,64,7,1,86
houston_texans_2014,915,656,259,18,1,85,18,4,475
houston_texans_2015,922,637,285,16,0,90,14,2,180
houston_texans_2016,947,660,287,29,0,70,11,1,132
indianapolis_colts_1984,0,0,0,16,0,0,7,0,33
indianapolis_colts_1985,0,0,0,19,0,0,8,0,53
indianapolis_colts_1986,0,0,0,16,1,0,5,0,23
indianapolis_colts_1987,0,0,0,17,1,0,4,0,34
indianapolis_colts_1988,0,0,0,20,0,0,4,1,97
indianapolis_colts_1989,0,0,0,22,0,0,13,1,279
indianapolis_colts_1990,0,0,0,10,0,0,3,0,61
indianapolis_colts_1991,0,0,0,15,0,0,10,0,123
indianapolis_colts_1992,0,0,0,19,0,0,10,1,214
indianapolis_colts_1993,0,0,0,8,0,0,5,0,42
indianapolis_colts_1994,0,0,0,5,0,0,8,0,138
indianapolis_colts_1995,0,0,0,6,0,0,7,1,154
indianapolis_colts_1996,0,0,0,10,1,0,8,3,135
indianapolis_colts_1997,0,0,0,11,0,0,4,2,182
indianapolis_colts_1998,0,0,0,17,0,0,3,0,31
indianapolis_colts_1999,0,0,0,16,0,0,0,0,0
indianapolis_colts_2000,0,0,0,21,0,0,6,0,43
indianapolis_colts_2001,569,422,147,24,0,29,10,0,68
indianapolis_colts_2002,700,552,148,13,0,52,10,1,170
indianapolis_colts_2003,585,450,135,11,0,43,11,1,155
indianapolis_colts_2004,641,512,129,10,0,33,11,1,53
indianapolis_colts_2005,634,484,150,13,0,30,8,0,86
indianapolis_colts_2006,655,497,158,16,0,36,9,0,96
indianapolis_colts_2007,722,554,168,21,1,35,12,1,182
indianapolis_colts_2008,855,648,207,5,0,25,7,1,46
indianapolis_colts_2009,824,624,200,15,0,56,14,2,153
indianapolis_colts_2010,762,569,193,8,0,31,7,0,131
indianapolis_colts_2011,874,507,367,24,0,40,6,2,76
indianapolis_colts_2012,852,617,235,31,0,61,12,4,155
indianapolis_colts_2013,887,617,270,17,2,69,15,1,186
indianapolis_colts_2014,855,609,246,32,0,71,12,1,143
indianapolis_colts_2015,939,626,313,34,1,73,17,4,196
indianapolis_colts_2016,929,682,247,22,0,58,8,0,100
jacksonville_jaguars_1995,0,0,0,8,0,0,4,1,76
jacksonville_jaguars_1996,0,0,0,10,0,0,9,0,47
jacksonville_jaguars_1997,0,0,0,14,0,0,10,0,119
jacksonville_jaguars_1998,0,0,0,7,0,0,9,0,109
jacksonville_jaguars_1999,0,0,0,11,0,0,13,2,283
jacksonville_jaguars_2000,0,0,0,17,0,0,5,0,75
jacksonville_jaguars_2001,584,483,101,22,0,30,9,0,69
jacksonville_jaguars_2002,304,261,43,4,0,19,2,0,9
jacksonville_jaguars_2003,338,259,79,3,0,23,6,0,12
jacksonville_jaguars_2004,524,411,113,17,2,33,13,0,122
jacksonville_jaguars_2005,359,286,73,11,0,19,9,2,133
jacksonville_jaguars_2006,436,355,81,8,0,29,14,0,174
jacksonville_jaguars_2007,577,491,86,7,0,39,14,2,211
jacksonville_jaguars_2008,568,491,77,12,0,37,11,2,189
jacksonville_jaguars_2009,612,503,109,7,0,28,7,0,106
jacksonville_jaguars_2010,491,380,111,13,0,22,3,0,39
jacksonville_jaguars_2011,674,464,210,13,0,42,10,0,85
jacksonville_jaguars_2012,719,577,142,11,0,37,7,0,94
jacksonville_jaguars_2013,809,636,173,25,1,51,7,1,125
jacksonville_jaguars_2014,930,649,281,32,0,40,5,1,80
jacksonville_jaguars_2015,976,733,243,29,0,71,9,1,120
jacksonville_jaguars_2016,908,727,181,30,0,55,7,1,104
kansas_city_chiefs_1971,0,0,0,0,0,0,1,0,3
kansas_city_chiefs_1972,0,0,0,0,0,0,0,0,0
kansas_city_chiefs_1973,0,0,0,0,0,0,0,0,0
kansas_city_chiefs_1974,0,0,0,0,0,0,1,1,52
kansas_city_chiefs_1975,0,0,0,0,0,0,0,0,0
kansas_city_chiefs_1976,0,0,0,0,0,0,0,0,0
kansas_city_chiefs_1977,0,0,0,0,0,0,1,0,6
kansas_city_chiefs_1978,0,0,0,0,0,0,3,0,21
kansas_city_chiefs_1979,0,0,0,0,0,0,1,0,28
kansas_city_chiefs_1980,0,0,0,0,0,0,9,0,54
kansas_city_chiefs_1981,0,0,0,0,0,0,10,0,143
kansas_city_chiefs_1982,0,0,0,6,0,0,3,1,66
kansas_city_chiefs_1983,0,0,0,14,0,0,11,0,142
kansas_city_chiefs_1984,0,0,0,18,0,0,18,1,311
kansas_city_chiefs_1985,0,0,0,24,0,0,16,1,167
kansas_city_chiefs_1986,0,0,0,18,0,0,15,0,188
kansas_city_chiefs_1987,0,0,0,17,0,0,4,0,58
kansas_city_chiefs_1988,0,0,0,10,3,0,11,0,78
kansas_city_chiefs_1989,0,0,0,11,0,0,7,0,85
kansas_city_chiefs_1990,0,0,0,23,1,0,9,1,98
kansas_city_chiefs_1991,0,0,0,15,1,0,11,0,95
kansas_city_chiefs_1992,0,0,0,12,0,0,15,2,136
kansas_city_chiefs_1993,0,0,0,17,0,0,12,0,129
kansas_city_chiefs_1994,0,0,0,6,1,0,2,0,24
kansas_city_chiefs_1995,0,0,0,22,0,0,13,2,247
kansas_city_chiefs_1996,0,0,0,7,1,0,9,0,115
kansas_city_chiefs_1997,0,0,0,22,2,0,9,1,101
kansas_city_chiefs_1998,0,0,0,24,1,0,8,0,92
kansas_city_chiefs_1999,0,0,0,27,0,0,23,5,343
kansas_city_chiefs_2000,0,0,0,7,0,0,11,2,165
kansas_city_chiefs_2001,628,529,99,16,1,30,9,1,110
kansas_city_chiefs_2002,687,571,116,7,0,36,16,0,302
kansas_city_chiefs_2003,471,404,67,10,0,30,13,1,169
kansas_city_chiefs_2004,485,419,66,17,0,30,11,1,150
kansas_city_chiefs_2005,550,457,93,10,0,42,9,1,175
kansas_city_chiefs_2006,691,590,101,28,0,39,13,0,101
kansas_city_chiefs_2007,728,593,135,19,0,52,10,0,94
kansas_city_chiefs_2008,688,552,136,8,0,48,10,2,221
kansas_city_chiefs_2009,664,558,106,18,1,72,9,2,244
kansas_city_chiefs_2010,784,592,192,20,0,90,12,3,200
kansas_city_chiefs_2011,771,578,193,15,0,77,17,2,279
kansas_city_chiefs_2012,699,587,112,16,1,58,5,0,70
kansas_city_chiefs_2013,787,676,111,23,0,92,21,5,488
kansas_city_chiefs_2014,848,708,140,24,0,70,6,1,95
kansas_city_chiefs_2015,877,715,162,45,1,88,22,4,477
kansas_city_chiefs_2016,931,749,182,17,0,103,18,4,271
los_angeles_raiders_1982,0,0,0,20,0,0,7,3,223
los_angeles_raiders_1983,0,0,0,28,1,0,7,2,107
los_angeles_raiders_1984,0,0,0,16,1,0,8,1,74
los_angeles_raiders_1985,0,0,0,20,1,0,4,1,114
los_angeles_raiders_1986,0,0,0,14,0,0,5,0,50
los_angeles_raiders_1987,0,0,0,13,0,0,5,1,114
los_angeles_raiders_1988,0,0,0,16,0,0,3,0,-6
los_angeles_raiders_1989,0,0,0,11,0,0,10,3,280
los_angeles_raiders_1990,0,0,0,15,0,0,8,0,77
los_angeles_raiders_1991,0,0,0,10,0,0,7,0,36
los_angeles_raiders_1992,0,0,0,8,1,0,5,1,152
los_angeles_raiders_1993,0,0,0,8,0,0,4,0,52
los_angeles_raiders_1994,0,0,0,13,0,0,3,1,65
los_angeles_rams_1970,0,0,0,0,0,0,0,0,0
los_angeles_rams_1971,0,0,0,0,0,0,0,0,0
los_angeles_rams_1972,0,0,0,0,0,0,0,0,0
los_angeles_rams_1973,0,0,0,0,0,0,2,0,52
los_angeles_rams_1974,0,0,0,0,0,0,0,0,0
los_angeles_rams_1975,0,0,0,0,1,0,1,0,15
los_angeles_rams_1976,0,0,0,0,0,0,0,0,0
los_angeles_rams_1977,0,0,0,0,0,0,0,0,0
los_angeles_rams_1978,0,0,0,0,0,0,0,0,0
los_angeles_rams_1979,0,0,0,0,0,0,0,0,0
los_angeles_rams_1980,0,0,0,0,0,0,8,1,244
los_angeles_rams_1981,0,0,0,0,0,0,3,0,18
los_angeles_rams_1982,0,0,0,13,0,0,2,0,16
los_angeles_rams_1983,0,0,0,16,1,0,14,2,280
los_angeles_rams_1984,0,0,0,25,0,0,9,2,214
los_angeles_rams_1985,0,0,0,22,0,0,18,3,262
los_angeles_rams_1986,0,0,0,19,1,0,12,2,231
los_angeles_rams_1987,0,0,0,11,0,0,6,1,116
los_angeles_rams_1988,0,0,0,8,0,0,13,0,99
los_angeles_rams_1989,0,0,0,10,0,0,5,1,128
los_angeles_rams_1990,0,0,0,9,0,0,7,0,53
los_angeles_rams_1991,0,0,0,7,0,0,2,0,62
los_angeles_rams_1992,0,0,0,10,0,0,9,1,113
los_angeles_rams_1993,0,0,0,8,0,0,4,0,42
los_angeles_rams_1994,0,0,0,14,1,0,5,1,84
los_angeles_rams_2016,960,737,223,30,0,73,10,0,71
miami_dolphins_1975,0,0,0,0,0,0,2,0,2
miami_dolphins_1976,0,0,0,0,0,0,0,0,0
miami_dolphins_1977,0,0,0,0,0,0,1,0,27
miami_dolphins_1978,0,0,0,0,0,0,6,0,39
miami_dolphins_1979,0,0,0,0,0,0,4,0,50
miami_dolphins_1980,0,0,0,0,0,0,4,0,44
miami_dolphins_1981,0,0,0,0,1,0,3,0,35
miami_dolphins_1982,0,0,0,7,0,0,2,0,19
miami_dolphins_1983,0,0,0,14,1,0,2,0,25
miami_dolphins_1984,0,0,0,9,0,0,3,0,25
miami_dolphins_1985,0,0,0,9,0,0,4,0,10
miami_dolphins_1986,0,0,0,10,0,0,2,0,16
miami_dolphins_1987,0,0,0,6,0,0,3,0,44
miami_dolphins_1988,0,0,0,2,0,0,5,0,64
miami_dolphins_1989,0,0,0,5,0,0,7,0,36
miami_dolphins_1990,0,0,0,7,0,0,8,1,146
miami_dolphins_1991,0,0,0,9,0,0,10,0,135
miami_dolphins_1992,0,0,0,3,0,0,8,1,247
miami_dolphins_1993,0,0,0,4,0,0,4,1,89
miami_dolphins_1994,0,0,0,3,0,0,9,1,144
miami_dolphins_1995,0,0,0,5,0,0,7,1,118
miami_dolphins_1996,0,0,0,8,0,0,9,2,256
miami_dolphins_1997,0,0,0,12,0,0,4,0,56
miami_dolphins_1998,0,0,0,15,0,0,16,2,146
miami_dolphins_1999,0,0,0,25,1,0,11,1,194
miami_dolphins_2000,0,0,0,8,1,0,20,0,237
miami_dolphins_2001,510,330,180,16,0,27,12,3,282
miami_dolphins_2002,553,380,173,11,0,37,12,0,151
miami_dolphins_2003,699,462,237,9,1,30,13,1,204
miami_dolphins_2004,561,336,225,19,1,30,5,0,29
miami_dolphins_2005,707,488,219,17,2,46,12,0,131
miami_dolphins_2006,621,406,215,12,0,61,6,2,83
miami_dolphins_2007,471,383,88,5,0,42,9,1,117
miami_dolphins_2008,377,311,66,6,1,52,9,1,117
miami_dolphins_2009,505,417,88,19,0,53,11,1,139
miami_dolphins_2010,690,562,128,17,0,69,10,0,66
miami_dolphins_2011,693,566,127,31,0,49,11,0,141
miami_dolphins_2012,681,532,149,17,0,49,7,0,66
miami_dolphins_2013,848,649,199,25,1,64,15,2,183
miami_dolphins_2014,832,664,168,23,1,40,12,2,268
miami_dolphins_2015,1024,757,267,29,0,69,12,3,146
miami_dolphins_2016,1065,680,385,16,0,73,16,1,186
minnesota_vikings_1977,0,0,0,0,0,0,0,0,0
minnesota_vikings_1978,0,0,0,0,0,0,2,0,0
minnesota_vikings_1979,0,0,0,0,0,0,6,0,110
minnesota_vikings_1980,0,0,0,0,0,0,7,2,176
minnesota_vikings_1981,0,0,0,0,1,0,7,0,52
minnesota_vikings_1982,0,0,0,4,0,0,2,0,4
minnesota_vikings_1983,0,0,0,13,0,0,2,0,2
minnesota_vikings_1984,0,0,0,12,0,0,1,0,0
minnesota_vikings_1985,0,0,0,16,1,0,2,0,63
minnesota_vikings_1986,0,0,0,14,0,0,3,0,69
minnesota_vikings_1987,0,0,0,19,0,0,4,0,20
minnesota_vikings_1988,0,0,0,16,0,0,4,0,53
minnesota_vikings_1989,0,0,0,10,0,0,0,0,0
minnesota_vikings_1990,0,0,0,15,0,0,1,1,26
minnesota_vikings_1991,0,0,0,21,0,0,0,0,0
minnesota_vikings_1992,0,0,0,23,0,0,16,3,278
minnesota_vikings_1993,0,0,0,19,1,0,15,0,86
minnesota_vikings_1994,0,0,0,20,0,0,15,4,315
minnesota_vikings_1995,0,0,0,20,0,0,13,1,161
minnesota_vikings_1996,0,0,0,16,0,0,10,1,112
minnesota_vikings_1997,0,0,0,11,0,0,7,0,73
minnesota_vikings_1998,0,0,0,9,0,0,2,0,27
minnesota_vikings_1999,0,0,0,3,0,0,4,1,51
minnesota_vikings_2000,0,0,0,18,0,0,5,0,12
minnesota_vikings_2001,542,404,138,13,0,37,4,0,-5
minnesota_vikings_2002,362,296,66,2,0,13,6,1,95
minnesota_vikings_2003,283,244,39,0,0,25,11,2,264
minnesota_vikings_2004,390,283,107,9,0,13,1,0,0
minnesota_vikings_2005,446,335,111,13,0,28,14,3,328
minnesota_vikings_2006,384,277,107,15,0,14,8,0,30
minnesota_vikings_2007,486,386,100,24,0,24,8,2,100
minnesota_vikings_2008,571,437,134,15,2,31,7,0,54
minnesota_vikings_2009,557,467,90,20,1,36,6,0,45
minnesota_vikings_2010,590,451,139,15,0,35,9,1,101
minnesota_vikings_2011,760,526,234,19,1,33,6,0,149
minnesota_vikings_2012,740,546,194,29,0,48,7,3,187
minnesota_vikings_2013,978,681,297,26,0,52,10,0,48
minnesota_vikings_2014,907,672,235,26,0,62,13,2,201
minnesota_vikings_2015,974,790,184,30,0,65,13,2,215
minnesota_vikings_2016,964,649,315,28,1,59,14,2,253
new_england_patriots_1971,0,0,0,0,0,0,0,0,0
new_england_patriots_1972,0,0,0,0,0,0,0,0,0
new_england_patriots_1973,0,0,0,0,0,0,0,0,0
new_england_patriots_1974,0,0,0,0,0,0,0,0,0
new_england_patriots_1975,0,0,0,0,0,0,2,0,8
new_england_patriots_1976,0,0,0,0,0,0,5,0,99
new_england_patriots_1977,0,0,0,0,0,0,3,0,39
new_england_patriots_1978,0,0,0,0,1,0,7,0,114
new_england_patriots_1979,0,0,0,0,0,0,3,0,56
new_england_patriots_1980,0,0,0,0,0,0,11,0,110
new_england_patriots_1981,0,0,0,0,0,0,7,0,60
new_england_patriots_1982,0,0,0,7,0,0,3,0,12
new_england_patriots_1983,0,0,0,27,0,0,8,1,136
new_england_patriots_1984,0,0,0,16,1,0,8,0,76
new_england_patriots_1985,0,0,0,9,0,0,14,0,333
new_england_patriots_1986,0,0,0,19,0,0,15,1,261
new_england_patriots_1987,0,0,0,15,0,0,9,2,184
new_england_patriots_1988,0,0,0,14,0,0,11,0,91
new_england_patriots_1989,0,0,0,10,0,0,5,0,69
new_england_patriots_1990,0,0,0,11,0,0,10,0,133
new_england_patriots_1991,0,0,0,14,0,0,7,0,70
new_england_patriots_1992,0,0,0,14,0,0,2,0,27
new_england_patriots_1993,0,0,0,15,0,0,4,0,44
new_england_patriots_1994,0,0,0,10,0,0,8,1,91
new_england_patriots_1995,0,0,0,7,0,0,7,0,74
new_england_patriots_1996,0,0,0,6,0,0,8,1,95
new_england_patriots_1997,0,0,0,21,0,0,5,1,130
new_england_patriots_1998,0,0,0,18,0,0,15,2,182
new_england_patriots_1999,0,0,0,17,0,0,10,2,92
new_england_patriots_2000,0,0,0,10,0,0,5,0,83
new_england_patriots_2001,472,336,136,17,0,29,6,2,132
new_england_patriots_2002,583,402,181,13,0,17,7,0,39
new_england_patriots_2003,788,567,221,27,0,52,14,2,185
new_england_patriots_2004,721,537,184,21,0,35,8,1,99
new_england_patriots_2005,562,402,160,11,0,27,6,2,77
new_england_patriots_2006,672,466,206,24,1,32,18,0,175
new_england_patriots_2007,677,513,164,19,0,52,16,2,279
new_england_patriots_2008,670,491,179,21,0,31,6,0,63
new_england_patriots_2009,500,357,143,9,0,22,4,1,93
new_england_patriots_2010,837,624,213,20,0,62,20,3,308
new_england_patriots_2011,896,590,306,18,0,53,20,2,239
new_england_patriots_2012,880,595,285,33,0,68,16,2,321
new_england_patriots_2013,956,571,385,31,0,72,16,2,220
new_england_patriots_2014,963,654,309,38,0,59,15,0,152
new_england_patriots_2015,986,685,301,36,0,85,12,0,176
new_england_patriots_2016,985,621,364,33,2,72,13,0,109
new_orleans_saints_1979,0,0,0,0,0,0,0,0,0
new_orleans_saints_1980,0,0,0,0,0,0,1,0,0
new_orleans_saints_1981,0,0,0,0,0,0,11,0,108
new_orleans_saints_1982,0,0,0,17,0,0,5,0,72
new_orleans_saints_1983,0,0,0,24,0,0,10,1,139
new_orleans_saints_1984,0,0,0,23,0,0,8,1,91
new_orleans_saints_1985,0,0,0,21,0,0,12,0,140
new_orleans_saints_1986,0,0,0,31,0,0,18,0,155
new_orleans_saints_1987,0,0,0,21,1,0,19,0,170
new_orleans_saints_1988,0,0,0,17,1,0,9,0,168
new_orleans_saints_1989,0,0,0,20,1,0,12,1,105
new_orleans_saints_1990,0,0,0,13,0,0,6,1,103
new_orleans_saints_1991,0,0,0,16,0,0,14,1,284
new_orleans_saints_1992,0,0,0,7,0,0,7,0,32
new_orleans_saints_1993,0,0,0,10,0,0,5,0,91
new_orleans_saints_1994,0,0,0,7,0,0,0,0,0
new_orleans_saints_1995,0,0,0,11,0,0,4,0,83
new_orleans_saints_1996,0,0,0,13,0,0,7,0,97
new_orleans_saints_1997,0,0,0,29,0,0,13,0,158
new_orleans_saints_1998,0,0,0,27,1,0,9,3,235
new_orleans_saints_1999,0,0,0,21,0,0,11,0,76
new_orleans_saints_2000,0,0,0,13,0,0,13,2,98
new_orleans_saints_2001,594,476,118,27,0,29,13,0,169
new_orleans_saints_2002,566,464,102,11,0,48,17,1,190
new_orleans_saints_2003,379,327,52,6,1,41,10,1,144
new_orleans_saints_2004,397,315,82,4,0,17,3,0,19
new_orleans_saints_2005,235,180,55,4,0,10,2,0,4
new_orleans_saints_2006,379,304,75,14,0,22,1,0,9
new_orleans_saints_2007,418,348,70,11,0,32,6,1,79
new_orleans_saints_2008,654,529,125,14,0,69,11,0,132
new_orleans_saints_2009,679,548,131,11,0,60,22,4,585
new_orleans_saints_2010,610,463,147,19,0,41,5,1,121
new_orleans_saints_2011,631,448,183,22,0,59,6,0,36
new_orleans_saints_2012,691,484,207,17,0,65,12,4,338
new_orleans_saints_2013,586,391,195,18,0,42,6,0,107
new_orleans_saints_2014,646,483,163,21,2,41,9,0,108
new_orleans_saints_2015,782,555,227,19,0,53,7,0,74
new_orleans_saints_2016,957,707,250,28,1,66,9,0,109
new_york_giants_1973,0,0,0,0,0,0,0,0,0
new_york_giants_1974,0,0,0,0,0,0,3,0,53
new_york_giants_1975,0,0,0,0,0,0,6,0,38
new_york_giants_1976,0,0,0,0,0,0,2,0,13
new_york_giants_1977,0,0,0,0,0,0,4,1,56
new_york_giants_1978,0,0,0,0,0,0,14,1,253
new_york_giants_1979,0,0,0,0,0,0,11,0,83
new_york_giants_1980,0,0,0,0,0,0,5,0,15
new_york_giants_1981,0,0,0,0,0,0,8,1,120
new_york_giants_1982,0,0,0,25,0,0,9,1,205
new_york_giants_1983,0,0,0,31,1,0,15,0,122
new_york_giants_1984,0,0,0,18,0,0,6,0,60
new_york_giants_1985,0,0,0,15,0,0,15,2,257
new_york_giants_1986,0,0,0,21,0,0,13,1,217
new_york_giants_1987,0,0,0,30,0,0,9,1,179
new_york_giants_1988,0,0,0,21,0,0,8,2,180
new_york_giants_1989,0,0,0,16,2,0,10,2,241
new_york_giants_1990,0,0,0,15,0,0,16,2,112
new_york_giants_1991,0,0,0,18,0,0,7,0,15
new_york_giants_1992,0,0,0,20,0,0,9,1,182
new_york_giants_1993,0,0,0,15,1,0,9,0,55
new_york_giants_1994,0,0,0,12,0,0,2,0,0
new_york_giants_1995,0,0,0,9,0,0,6,2,149
new_york_giants_1996,0,0,0,13,0,0,13,2,229
new_york_giants_1997,0,0,0,19,0,0,14,3,284
new_york_giants_1998,0,0,0,18,0,0,10,2,126
new_york_giants_1999,0,0,0,16,0,0,13,0,118
new_york_giants_2000,0,0,0,12,0,0,8,0,63
new_york_giants_2001,588,455,133,15,0,49,10,1,69
new_york_giants_2002,444,353,91,5,0,33,6,1,43
new_york_giants_2003,515,396,119,7,0,27,6,1,100
new_york_giants_2004,732,551,181,26,0,45,9,0,56
new_york_giants_2005,589,463,126,6,0,53,10,0,237
new_york_giants_2006,614,488,126,21,1,45,11,0,113
new_york_giants_2007,432,338,94,14,0,34,6,1,121
new_york_giants_2008,514,400,114,22,1,47,9,0,134
new_york_giants_2009,536,412,124,18,0,51,12,2,197
new_york_giants_2010,527,402,125,12,0,54,10,0,67
new_york_giants_2011,541,397,144,24,2,47,12,0,130
new_york_giants_2012,501,366,135,22,0,30,6,1,73
new_york_giants_2013,688,515,173,19,0,49,6,1,111
new_york_giants_2014,658,483,175,29,0,53,12,0,140
new_york_giants_2015,908,665,243,20,1,70,10,2,162
new_york_giants_2016,1083,769,314,33,0,101,17,1,174
new_york_jets_1976,0,0,0,0,0,0,0,0,0
new_york_jets_1977,0,0,0,0,0,0,0,0,0
new_york_jets_1978,0,0,0,0,0,0,0,0,0
new_york_jets_1979,0,0,0,0,0,0,1,0,4
new_york_jets_1980,0,0,0,0,0,0,8,1,91
new_york_jets_1981,0,0,0,0,0,0,2,0,58
new_york_jets_1982,0,0,0,14,0,0,1,0,34
new_york_jets_1983,0,0,0,14,0,0,2,0,6
new_york_jets_1984,0,0,0,11,0,0,6,0,39
new_york_jets_1985,0,0,0,10,0,0,6,1,29
new_york_jets_1986,0,0,0,11,0,0,1,0,29
new_york_jets_1987,0,0,0,13,0,0,6,0,79
new_york_jets_1988,0,0,0,17,0,0,7,1,58
new_york_jets_1989,0,0,0,12,0,0,7,1,64
new_york_jets_1990,0,0,0,17,0,0,6,0,22
new_york_jets_1991,0,0,0,13,0,0,7,0,60
new_york_jets_1992,0,0,0,20,1,0,9,1,78
new_york_jets_1993,0,0,0,21,0,0,14,1,195
new_york_jets_1994,0,0,0,21,0,0,12,2,200
new_york_jets_1995,0,0,0,19,0,0,5,1,59
new_york_jets_1996,0,0,0,10,0,0,5,2,113
new_york_jets_1997,0,0,0,16,0,0,3,1,61
new_york_jets_1998,0,0,0,17,0,0,9,1,65
new_york_jets_1999,0,0,0,14,0,0,5,0,40
new_york_jets_2000,0,0,0,19,0,0,9,0,78
new_york_jets_2001,569,428,141,13,0,25,8,1,183
new_york_jets_2002,626,502,124,15,0,43,11,0,195
new_york_jets_2003,649,458,191,14,0,28,8,0,113
new_york_jets_2004,708,514,194,20,0,37,9,2,168
new_york_jets_2005,732,539,193,13,0,32,17,1,224
new_york_jets_2006,656,445,211,23,0,26,8,0,46
new_york_jets_2007,678,502,176,16,0,46,11,0,98
new_york_jets_2008,845,621,224,29,0,57,10,3,205
new_york_jets_2009,725,542,183,27,0,65,15,1,247
new_york_jets_2010,611,466,145,29,1,45,5,2,90
new_york_jets_2011,563,436,127,26,1,48,13,2,271
new_york_jets_2012,756,534,222,19,0,34,7,1,59
new_york_jets_2013,801,495,306,14,0,30,7,1,116
new_york_jets_2014,910,596,314,34,1,39,4,0,11
new_york_jets_2015,882,584,298,25,0,60,18,0,191
new_york_jets_2016,954,633,321,23,0,54,8,0,141
oakland_raiders_1977,0,0,0,0,0,0,0,0,0
oakland_raiders_1978,0,0,0,0,0,0,1,0,0
oakland_raiders_1979,0,0,0,0,0,0,3,0,30
oakland_raiders_1980,0,0,0,0,0,0,6,0,103
oakland_raiders_1981,0,0,0,0,0,0,3,0,19
oakland_raiders_1995,0,0,0,8,0,0,1,0,0
oakland_raiders_1996,0,0,0,10,0,0,4,1,87
oakland_raiders_1997,0,0,0,6,0,0,2,1,44
oakland_raiders_1998,0,0,0,12,0,0,12,1,180
oakland_raiders_1999,0,0,0,15,0,0,10,0,95
oakland_raiders_2000,0,0,0,21,0,0,15,4,262
oakland_raiders_2001,477,380,97,16,0,29,10,0,146
oakland_raiders_2002,454,361,93,16,0,30,7,0,40
oakland_raiders_2003,483,367,116,7,0,12,3,0,19
oakland_raiders_2004,587,462,125,13,0,28,3,0,76
oakland_raiders_2005,520,446,74,15,0,43,3,0,38
oakland_raiders_2006,451,366,85,6,0,36,14,2,168
oakland_raiders_2007,465,381,84,8,1,27,4,0,20
oakland_raiders_2008,520,416,104,23,1,47,11,0,143
oakland_raiders_2009,611,480,131,26,0,40,5,0,20
oakland_raiders_2010,532,406,126,24,1,36,6,1,55
oakland_raiders_2011,546,422,124,27,1,47,10,0,146
oakland_raiders_2012,739,551,188,19,0,38,8,0,84
oakland_raiders_2013,667,521,146,24,0,27,7,1,70
oakland_raiders_2014,573,456,117,15,0,34,2,0,27
oakland_raiders_2015,828,673,155,21,2,77,9,1,51
oakland_raiders_2016,918,712,206,13,0,73,16,1,147
philadelphia_eagles_1974,0,0,0,0,0,0,0,0,0
philadelphia_eagles_1975,0,0,0,0,0,0,4,1,133
philadelphia_eagles_1976,0,0,0,0,0,0,0,0,0
philadelphia_eagles_1977,0,0,0,0,0,0,0,0,0
philadelphia_eagles_1978,0,0,0,0,0,0,4,1,34
philadelphia_eagles_1979,0,0,0,0,0,0,0,0,0
philadelphia_eagles_1980,0,0,0,0,0,0,5,0,16
philadelphia_eagles_1981,0,0,0,0,0,0,3,0,28
philadelphia_eagles_1982,0,0,0,7,0,0,0,0,0
philadelphia_eagles_1983,0,0,0,10,0,0,1,0,18
philadelphia_eagles_1984,0,0,0,10,0,0,7,0,119
philadelphia_eagles_1985,0,0,0,3,0,0,5,0,42
philadelphia_eagles_1986,0,0,0,6,0,0,10,0,56
philadelphia_eagles_1987,0,0,0,9,0,0,5,0,75
philadelphia_eagles_1988,0,0,0,4,1,0,9,0,119
philadelphia_eagles_1989,0,0,0,15,1,0,24,1,257
philadelphia_eagles_1990,0,0,0,7,0,0,5,2,92
philadelphia_eagles_1991,0,0,0,7,0,0,9,0,79
philadelphia_eagles_1992,0,0,0,14,0,0,11,0,152
philadelphia_eagles_1993,0,0,0,14,1,0,10,4,267
philadelphia_eagles_1994,0,0,0,21,0,0,17,2,199
philadelphia_eagles_1995,0,0,0,16,0,0,12,1,204
philadelphia_eagles_1996,0,0,0,25,0,0,17,1,285
philadelphia_eagles_1997,0,0,0,33,0,0,12,1,186
philadelphia_eagles_1998,0,0,0,24,0,0,8,0,140
philadelphia_eagles_1999,0,0,0,23,1,0,22,4,514
philadelphia_eagles_2000,0,0,0,13,0,0,15,1,195
philadelphia_eagles_2001,553,453,100,11,0,76,9,1,75
philadelphia_eagles_2002,720,565,155,25,0,79,13,2,152
philadelphia_eagles_2003,639,527,112,20,0,46,10,1,109
philadelphia_eagles_2004,463,398,65,22,0,39,7,0,62
philadelphia_eagles_2005,566,484,82,24,0,43,5,0,37
philadelphia_eagles_2006,530,399,131,28,0,52,10,2,172
philadelphia_eagles_2007,545,409,136,16,0,30,3,0,50
philadelphia_eagles_2008,501,395,106,27,0,58,8,2,178
philadelphia_eagles_2009,506,413,93,17,0,38,12,0,137
philadelphia_eagles_2010,595,516,79,26,0,60,18,1,182
philadelphia_eagles_2011,754,605,149,18,0,60,15,1,192
philadelphia_eagles_2012,724,577,147,26,0,68,7,0,31
philadelphia_eagles_2013,819,641,178,32,2,76,14,1,232
philadelphia_eagles_2014,897,707,190,33,0,69,9,2,146
philadelphia_eagles_2015,955,716,239,35,1,70,14,3,280
philadelphia_eagles_2016,903,655,248,30,0,77,16,3,207
phoenix_cardinals_1988,0,0,0,15,1,0,4,0,35
phoenix_cardinals_1989,0,0,0,25,0,0,7,1,68
phoenix_cardinals_1990,0,0,0,25,0,0,8,0,91
phoenix_cardinals_1991,0,0,0,19,0,0,1,0,27
phoenix_cardinals_1992,0,0,0,14,0,0,5,0,64
phoenix_cardinals_1993,0,0,0,20,0,0,2,0,0
pittsburgh_steelers_1971,0,0,0,0,0,0,2,0,4
pittsburgh_steelers_1972,0,0,0,0,0,0,7,1,83
pittsburgh_steelers_1973,0,0,0,0,0,0,4,0,43
pittsburgh_steelers_1974,0,0,0,0,0,0,7,0,32
pittsburgh_steelers_1975,0,0,0,0,0,0,3,0,37
pittsburgh_steelers_1976,0,0,0,0,1,0,4,0,45
pittsburgh_steelers_1977,0,0,0,0,0,0,5,0,22
pittsburgh_steelers_1978,0,0,0,0,0,0,8,0,60
pittsburgh_steelers_1979,0,0,0,0,0,0,8,0,37
pittsburgh_steelers_1980,0,0,0,0,1,0,4,0,17
pittsburgh_steelers_1981,0,0,0,0,0,0,7,0,99
pittsburgh_steelers_1982,0,0,0,18,0,0,3,0,28
pittsburgh_steelers_1983,0,0,0,20,1,0,2,0,-1
pittsburgh_steelers_1984,0,0,0,14,0,0,0,0,0
pittsburgh_steelers_1985,0,0,0,8,0,0,2,0,0
pittsburgh_steelers_1986,0,0,0,11,0,0,0,0,0
pittsburgh_steelers_1987,0,0,0,10,1,0,7,1,55
pittsburgh_steelers_1988,0,0,0,11,0,0,6,0,58
pittsburgh_steelers_1989,0,0,0,9,0,0,9,0,97
pittsburgh_steelers_1990,0,0,0,11,0,0,8,1,97
pittsburgh_steelers_1991,0,0,0,7,0,0,6,0,58
pittsburgh_steelers_1992,0,0,0,12,0,0,13,0,142
pittsburgh_steelers_1993,0,0,0,14,0,0,13,0,227
pittsburgh_steelers_1994,0,0,0,14,0,0,10,0,114
pittsburgh_steelers_1995,0,0,0,14,0,0,11,2,154
pittsburgh_steelers_1996,0,0,0,25,0,0,13,2,192
pittsburgh_steelers_1997,0,0,0,28,0,0,14,0,129
pittsburgh_steelers_1998,0,0,0,15,0,0,15,3,299
pittsburgh_steelers_1999,0,0,0,26,0,0,9,0,72
pittsburgh_steelers_2000,0,0,0,6,0,0,15,0,140
pittsburgh_steelers_2001,566,448,118,21,0,55,11,2,258
pittsburgh_steelers_2002,691,493,198,34,0,53,11,1,149
pittsburgh_steelers_2003,684,515,169,24,0,40,11,1,191
pittsburgh_steelers_2004,401,299,102,15,0,27,7,1,137
pittsburgh_steelers_2005,589,420,169,26,1,46,3,0,28
pittsburgh_steelers_2006,583,406,177,23,0,34,6,1,76
pittsburgh_steelers_2007,681,471,210,26,0,43,6,1,90
pittsburgh_steelers_2008,689,462,227,16,1,44,7,1,198
pittsburgh_steelers_2009,712,534,178,21,0,43,5,2,173
pittsburgh_steelers_2010,659,471,188,23,0,54,8,1,94
pittsburgh_steelers_2011,547,395,152,20,0,44,5,0,41
pittsburgh_steelers_2012,553,362,191,26,0,30,4,1,83
pittsburgh_steelers_2013,655,475,180,19,0,41,4,1,74
pittsburgh_steelers_2014,791,541,250,24,0,40,8,4,185
pittsburgh_steelers_2015,1030,750,280,45,0,81,17,2,282
pittsburgh_steelers_2016,994,707,287,35,0,80,13,0,133
san_diego_chargers_1975,0,0,0,0,0,0,0,0,0
san_diego_chargers_1976,0,0,0,0,0,0,0,0,0
san_diego_chargers_1977,0,0,0,0,0,0,1,1,22
san_diego_chargers_1978,0,0,0,0,0,0,3,1,55
san_diego_chargers_1979,0,0,0,0,1,0,0,0,0
san_diego_chargers_1980,0,0,0,0,0,0,1,0,2
san_diego_chargers_1981,0,0,0,0,0,0,2,1,69
san_diego_chargers_1982,0,0,0,15,1,0,6,0,112
san_diego_chargers_1983,0,0,0,18,0,0,5,1,82
san_diego_chargers_1984,0,0,0,17,0,0,5,0,119
san_diego_chargers_1985,0,0,0,10,0,0,4,0,37
san_diego_chargers_1986,0,0,0,9,0,0,4,1,53
san_diego_chargers_1987,0,0,0,17,0,0,6,2,261
san_diego_chargers_1988,0,0,0,15,0,0,2,0,0
san_diego_chargers_1989,0,0,0,4,0,0,8,0,98
san_diego_chargers_1990,0,0,0,5,0,0,3,0,0
san_diego_chargers_1991,0,0,0,18,0,0,7,0,35
san_diego_chargers_1992,0,0,0,8,0,0,11,1,229
san_diego_chargers_1993,0,0,0,7,0,0,11,0,163
san_diego_chargers_1994,0,0,0,15,0,0,14,2,335
san_diego_chargers_1995,0,0,0,21,1,0,13,1,175
san_diego_chargers_1996,0,0,0,21,0,0,15,0,168
san_diego_chargers_1997,0,0,0,20,0,0,9,2,188
san_diego_chargers_1998,0,0,0,19,0,0,15,0,189
san_diego_chargers_1999,0,0,0,19,0,0,8,0,26
san_diego_chargers_2000,0,0,0,24,1,0,11,1,128
san_diego_chargers_2001,570,476,94,22,0,30,7,1,98
san_diego_chargers_2002,662,535,127,26,0,37,9,1,147
san_diego_chargers_2003,740,609,131,21,0,32,11,1,134
san_diego_chargers_2004,839,644,195,15,0,67,19,1,168
san_diego_chargers_2005,778,609,169,32,0,65,6,2,167
san_diego_chargers_2006,664,489,175,22,0,50,14,0,130
san_diego_chargers_2007,510,399,111,18,0,49,12,1,113
san_diego_chargers_2008,633,501,132,15,0,48,7,1,78
san_diego_chargers_2009,549,430,119,19,0,36,8,1,125
san_diego_chargers_2010,611,494,117,23,0,51,10,2,166
san_diego_chargers_2011,758,587,171,20,0,57,15,0,189
san_diego_chargers_2012,763,573,190,35,1,55,9,3,196
san_diego_chargers_2013,915,725,190,30,0,60,10,1,141
san_diego_chargers_2014,955,716,239,23,0,52,7,0,65
san_diego_chargers_2015,862,671,191,19,0,54,8,1,146
san_diego_chargers_2016,952,732,220,24,0,84,18,3,292
san_francisco_49ers_1973,0,0,0,0,0,0,0,0,0
san_francisco_49ers_1974,0,0,0,0,0,0,0,0,0
san_francisco_49ers_1975,0,0,0,0,0,0,0,0,0
san_francisco_49ers_1976,0,0,0,0,0,0,0,0,0
san_francisco_49ers_1977,0,0,0,0,0,0,1,0,6
san_francisco_49ers_1978,0,0,0,0,0,0,0,0,0
san_francisco_49ers_1979,0,0,0,0,0,0,0,0,0
san_francisco_49ers_1980,0,0,0,0,0,0,2,0,23
san_francisco_49ers_1981,0,0,0,0,0,0,1,0,0
san_francisco_49ers_1982,0,0,0,8,0,0,2,0,0
san_francisco_49ers_1983,0,0,0,14,0,0,4,0,66
san_francisco_49ers_1984,0,0,0,19,1,0,2,0,9
san_francisco_49ers_1985,0,0,0,19,1,0,1,0,0
san_francisco_49ers_1986,0,0,0,10,0,0,5,0,60
san_francisco_49ers_1987,0,0,0,14,0,0,2,0,16
san_francisco_49ers_1988,0,0,0,18,1,0,1,0,0
san_francisco_49ers_1989,0,0,0,12,0,0,3,0,36
san_francisco_49ers_1990,0,0,0,13,0,0,8,0,77
san_francisco_49ers_1991,0,0,0,22,0,0,5,0,88
san_francisco_49ers_1992,0,0,0,13,0,0,10,1,168
san_francisco_49ers_1993,0,0,0,14,0,0,8,2,149
san_francisco_49ers_1994,0,0,0,22,0,0,17,3,404
san_francisco_49ers_1995,0,0,0,23,0,0,12,3,218
san_francisco_49ers_1996,0,0,0,2,2,0,5,0,10
san_francisco_49ers_1997,0,0,0,13,0,0,10,1,152
san_francisco_49ers_1998,0,0,0,13,0,0,10,0,111
san_francisco_49ers_1999,0,0,0,7,1,0,7,2,154
san_francisco_49ers_2000,0,0,0,23,0,0,5,1,111
san_francisco_49ers_2001,501,407,94,20,0,28,6,0,61
san_francisco_49ers_2002,511,406,105,14,0,33,9,1,243
san_francisco_49ers_2003,549,427,122,28,1,42,13,0,257
san_francisco_49ers_2004,539,419,120,18,0,27,7,0,114
san_francisco_49ers_2005,609,471,138,19,0,39,10,2,110
san_francisco_49ers_2006,506,391,115,10,0,27,10,1,108
san_francisco_49ers_2007,450,335,115,14,1,26,6,0,60
san_francisco_49ers_2008,382,296,86,12,0,25,3,0,25
san_francisco_49ers_2009,344,268,76,17,0,16,6,0,49
san_francisco_49ers_2010,407,333,74,16,0,16,2,1,71
san_francisco_49ers_2011,447,359,88,12,1,40,10,0,119
san_francisco_49ers_2012,520,378,142,11,0,32,7,2,130
san_francisco_49ers_2013,632,517,115,24,1,59,15,2,264
san_francisco_49ers_2014,573,466,107,25,0,60,16,2,242
san_francisco_49ers_2015,997,766,231,25,0,57,9,1,125
san_francisco_49ers_2016,1073,803,270,29,0,73,10,0,96
seattle_seahawks_1978,0,0,0,0,0,0,4,0,65
seattle_seahawks_1979,0,0,0,0,0,0,2,0,30
seattle_seahawks_1980,0,0,0,0,0,0,8,0,37
seattle_seahawks_1981,0,0,0,0,0,0,15,3,361
seattle_seahawks_1982,0,0,0,7,0,0,11,1,141
seattle_seahawks_1983,0,0,0,11,0,0,10,0,129
seattle_seahawks_1984,0,0,0,22,0,0,22,3,316
seattle_seahawks_1985,0,0,0,25,0,0,9,0,42
seattle_seahawks_1986,0,0,0,25,0,0,5,0,52
seattle_seahawks_1987,0,0,0,14,0,0,10,1,196
seattle_seahawks_1988,0,0,0,4,0,0,5,0,60
seattle_seahawks_1989,0,0,0,10,0,0,3,0,33
seattle_seahawks_1990,0,0,0,4,0,0,5,0,69
seattle_seahawks_1991,0,0,0,9,0,0,6,0,117
seattle_seahawks_1992,0,0,0,6,0,0,5,0,77
seattle_seahawks_1993,0,0,0,9,1,0,3,1,25
seattle_seahawks_1994,0,0,0,12,0,0,0,0,0
seattle_seahawks_1995,0,0,0,15,1,0,3,0,-5
seattle_seahawks_1996,0,0,0,19,0,0,4,0,43
seattle_seahawks_1997,0,0,0,22,1,0,1,0,13
seattle_seahawks_1998,0,0,0,18,0,0,5,1,90
seattle_seahawks_1999,0,0,0,24,0,0,12,1,93
seattle_seahawks_2000,0,0,0,10,0,0,8,2,203
seattle_seahawks_2001,473,371,102,8,0,13,6,2,132
seattle_seahawks_2002,523,397,126,12,0,29,7,1,145
seattle_seahawks_2003,459,355,104,20,0,18,7,0,38
seattle_seahawks_2004,434,336,98,12,0,10,4,0,48
seattle_seahawks_2005,585,450,135,18,0,27,6,1,111
seattle_seahawks_2006,654,513,141,21,0,28,8,1,123
seattle_seahawks_2007,551,446,105,21,1,40,9,0,115
seattle_seahawks_2008,564,457,107,26,0,29,2,1,51
seattle_seahawks_2009,457,352,105,18,0,21,2,0,18
seattle_seahawks_2010,467,353,114,6,1,52,9,1,131
seattle_seahawks_2011,572,411,161,10,1,46,10,0,91
seattle_seahawks_2012,737,487,250,20,0,58,15,2,216
seattle_seahawks_2013,897,578,319,34,1,78,27,3,336
seattle_seahawks_2014,844,599,245,30,1,63,13,2,319
seattle_seahawks_2015,884,571,313,25,0,71,14,0,205
seattle_seahawks_2016,1038,600,438,21,0,69,11,0,72
st_louis_cardinals_1976,0,0,0,0,0,0,0,0,0
st_louis_cardinals_1977,0,0,0,0,0,0,4,0,37
st_louis_cardinals_1978,0,0,0,0,0,0,1,0,-3
st_louis_cardinals_1979,0,0,0,0,0,0,0,0,0
st_louis_cardinals_1980,0,0,0,0,0,0,0,0,0
st_louis_cardinals_1981,0,0,0,0,0,0,1,1,14
st_louis_cardinals_1982,0,0,0,6,0,0,3,0,42
st_louis_cardinals_1983,0,0,0,8,1,0,22,0,226
st_louis_cardinals_1984,0,0,0,14,0,0,9,0,64
st_louis_cardinals_1985,0,0,0,13,0,0,6,1,58
st_louis_cardinals_1986,0,0,0,22,0,0,6,0,61
st_louis_cardinals_1987,0,0,0,15,0,0,5,0,13
st_louis_rams_1995,0,0,0,19,1,0,6,0,52
st_louis_rams_1996,0,0,0,25,0,0,9,2,136
st_louis_rams_1997,0,0,0,15,0,0,2,0,27
st_louis_rams_1998,0,0,0,22,0,0,4,0,72
st_louis_rams_1999,0,0,0,19,1,0,4,0,92
st_louis_rams_2000,0,0,0,18,0,0,4,0,33
st_louis_rams_2001,476,372,104,18,0,16,4,0,73
st_louis_rams_2002,497,409,88,16,0,20,4,0,31
st_louis_rams_2003,548,464,84,20,0,36,10,2,312
st_louis_rams_2004,680,552,128,31,0,29,1,0,30
st_louis_rams_2005,758,623,135,30,0,37,5,1,181
st_louis_rams_2006,546,493,53,14,0,23,9,1,127
st_louis_rams_2007,595,498,97,17,1,37,13,1,152
st_louis_rams_2008,617,524,93,23,0,31,9,0,128
st_louis_rams_2009,641,556,85,20,0,36,3,1,57
st_louis_rams_2010,708,608,100,27,1,60,9,0,117
st_louis_rams_2011,642,520,122,23,1,47,7,1,116
st_louis_rams_2012,432,350,82,20,0,41,9,3,199
st_louis_rams_2013,714,594,120,29,1,63,10,2,226
st_louis_rams_2014,819,679,140,27,0,61,13,3,276
st_louis_rams_2015,973,692,281,28,0,70,12,1,182
tampa_bay_buccaneers_1976,0,0,0,0,0,0,0,0,0
tampa_bay_buccaneers_1977,0,0,0,0,0,0,1,0,0
tampa_bay_buccaneers_1978,0,0,0,0,0,0,2,0,5
tampa_bay_buccaneers_1979,0,0,0,0,0,0,0,0,0
tampa_bay_buccaneers_1980,0,0,0,0,0,0,0,0,0
tampa_bay_buccaneers_1981,0,0,0,0,0,0,5,0,84
tampa_bay_buccaneers_1982,0,0,0,5,0,0,0,0,0
tampa_bay_buccaneers_1983,0,0,0,9,0,0,2,0,11
tampa_bay_buccaneers_1984,0,0,0,17,0,0,2,0,0
tampa_bay_buccaneers_1985,0,0,0,11,0,0,3,0,34
tampa_bay_buccaneers_1986,0,0,0,9,0,0,2,0,12
tampa_bay_buccaneers_1987,0,0,0,19,0,0,1,0,11
tampa_bay_buccaneers_1988,0,0,0,13,0,0,14,0,168
tampa_bay_buccaneers_1989,0,0,0,18,0,0,13,2,170
tampa_bay_buccaneers_1990,0,0,0,21,0,0,11,0,137
tampa_bay_buccaneers_1991,0,0,0,26,0,0,4,0,13
tampa_bay_buccaneers_1992,0,0,0,24,0,0,10,1,82
tampa_bay_buccaneers_1993,0,0,0,14,0,0,6,2,42
tampa_bay_buccaneers_1994,0,0,0,6,0,0,6,0,39
tampa_bay_buccaneers_1995,0,0,0,9,0,0,9,1,94
tampa_bay_buccaneers_1996,0,0,0,29,0,0,12,0,81
tampa_bay_buccaneers_1997,0,0,0,14,0,0,8,0,40
tampa_bay_buccaneers_1998,0,0,0,24,0,0,5,0,100
tampa_bay_buccaneers_1999,0,0,0,11,0,0,12,2,219
tampa_bay_buccaneers_2000,0,0,0,15,0,0,11,2,142
tampa_bay_buccaneers_2001,505,390,115,15,0,45,21,2,324
tampa_bay_buccaneers_2002,559,443,116,14,0,47,18,1,237
tampa_bay_buccaneers_2003,613,486,127,11,0,27,9,2,146
tampa_bay_buccaneers_2004,594,473,121,11,0,45,11,0,168
tampa_bay_buccaneers_2005,602,460,142,8,1,43,14,0,177
tampa_bay_buccaneers_2006,574,445,129,6,0,32,5,2,148
tampa_bay_buccaneers_2007,353,294,59,13,0,32,8,1,34
tampa_bay_buccaneers_2008,339,266,73,12,0,45,15,2,329
tampa_bay_buccaneers_2009,348,296,52,6,0,36,10,0,142
tampa_bay_buccaneers_2010,354,293,61,8,0,35,11,1,224
tampa_bay_buccaneers_2011,434,345,89,16,1,30,8,3,114
tampa_bay_buccaneers_2012,714,563,151,23,0,59,13,2,285
tampa_bay_buccaneers_2013,954,712,242,33,1,71,21,3,338
tampa_bay_buccaneers_2014,1013,756,257,31,0,61,14,3,155
tampa_bay_buccaneers_2015,1027,722,305,30,0,62,11,1,93
tampa_bay_buccaneers_2016,944,759,185,36,0,87,17,4,234
tennessee_oilers_1997,0,0,0,20,0,0,7,2,168
tennessee_oilers_1998,0,0,0,12,0,0,8,1,73
tennessee_titans_1999,0,0,0,17,1,0,3,0,46
tennessee_titans_2000,0,0,0,25,0,0,5,2,116
tennessee_titans_2001,516,379,137,14,1,26,2,0,5
tennessee_titans_2002,360,267,93,20,0,19,6,0,56
tennessee_titans_2003,403,297,106,23,0,16,4,0,26
tennessee_titans_2004,508,382,126,14,0,16,6,1,76
tennessee_titans_2005,468,333,135,11,1,22,2,1,21
tennessee_titans_2006,454,336,118,11,0,23,8,1,144
tennessee_titans_2007,524,410,114,17,0,39,9,0,81
tennessee_titans_2008,592,463,129,22,0,48,11,2,198
tennessee_titans_2009,625,464,161,18,0,22,2,0,7
tennessee_titans_2010,660,499,161,14,1,46,11,0,114
tennessee_titans_2011,674,515,159,19,0,49,7,1,153
tennessee_titans_2012,874,620,254,25,0,64,18,3,318
tennessee_titans_2013,718,553,165,18,0,63,9,1,77
tennessee_titans_2014,792,571,221,28,0,53,11,1,122
tennessee_titans_2015,934,652,282,35,0,57,10,1,156
tennessee_titans_2016,896,674,222,28,0,76,12,0,68
washington_redskins_1979,0,0,0,0,0,0,1,0,4
washington_redskins_1980,0,0,0,0,0,0,0,0,0
washington_redskins_1981,0,0,0,0,0,0,4,1,47
washington_redskins_1982,0,0,0,11,0,0,1,0,-2
washington_redskins_1983,0,0,0,8,1,0,4,1,108
washington_redskins_1984,0,0,0,16,0,0,0,0,0
washington_redskins_1985,0,0,0,14,0,0,4,0,31
washington_redskins_1986,0,0,0,13,0,0,2,0,19
washington_redskins_1987,0,0,0,36,0,0,3,0,28
washington_redskins_1988,0,0,0,32,1,0,6,0,115
washington_redskins_1989,0,0,0,19,1,0,11,2,182
washington_redskins_1990,0,0,0,20,0,0,11,1,144
washington_redskins_1991,0,0,0,16,0,0,13,2,147
washington_redskins_1992,0,0,0,23,0,0,14,1,189
washington_redskins_1993,0,0,0,16,0,0,8,2,182
washington_redskins_1994,0,0,0,6,0,0,7,0,103
washington_redskins_1995,0,0,0,23,0,0,9,1,147
washington_redskins_1996,0,0,0,22,0,0,11,0,99
washington_redskins_1997,0,0,0,18,0,0,10,1,80
washington_redskins_1998,0,0,0,17,0,0,7,0,137
washington_redskins_1999,0,0,0,12,0,0,9,2,132
washington_redskins_2000,0,0,0,14,0,0,11,0,154
washington_redskins_2001,551,466,85,8,0,32,14,1,173
washington_redskins_2002,598,472,126,12,0,43,8,1,152
washington_redskins_2003,593,494,99,15,1,35,9,0,84
washington_redskins_2004,580,457,123,18,0,26,10,1,271
washington_redskins_2005,551,452,99,21,0,43,9,1,150
washington_redskins_2006,689,511,178,15,1,34,3,0,21
washington_redskins_2007,556,408,148,11,2,41,8,1,134
washington_redskins_2008,479,334,145,14,0,41,4,0,24
washington_redskins_2009,550,412,138,10,0,35,6,0,128
washington_redskins_2010,691,470,221,18,0,47,9,1,100
washington_redskins_2011,771,488,283,27,0,52,11,1,127
washington_redskins_2012,652,418,234,22,0,54,15,2,187
washington_redskins_2013,684,456,228,21,0,42,9,4,127
washington_redskins_2014,684,489,195,13,0,35,5,0,16
washington_redskins_2015,927,596,331,33,1,59,10,1,173
washington_redskins_2016,1026,717,309,24,0,73,13,0,186
